CCCCCCCCCCCCCCCCCCCCCCCCCCCCCCCC
CCCC------------------------CCCC
CCCC---E---S--------S---E---CCCC
CCCC-----LMMMR----LMMMR-----CCCC
C----------S--------S----------C
C-----S------------------S-----C
C---LMMMR-----LMMR-----LMMMR---C
C-----S------------------S-----C
C------------------------------C
CMR--------LMMMMMMMMR--------LMC
C-----------------------S------C
C------S---------------LMR-----C
C-----LMR-----P---------S------C
C------S-----------------------C
CMR--------LMMMMMMMMR--------LMC
C------------------------------C
C-----S------------------S-----C
C---LMMMR-----LMMR-----LMMMR---C
C-----S------------------S-----C
C----------S--------S----------C
CMMM-----LMMMR----LMMMR-----MMMC
CCCC---E---S--------S---E---CCCC
CCCC------------------------CCCC
CCCCMMMMMMMMMMMMMMMMMMMMMMMMCCCC


